____________________________
|       gg                 |
|       gg                 |
|  bb  bb  bb  bb  bb  bb  |
|  bb  bb  bb  bb  bb  bb  |
|  bb  bb  bb  bb  bb  bb  |
|  bb  bb  bb  bb  bb  bb  |
|  bb  bb  bbssbb  bb  bb  |
|  bb  bb  bbssbb  bb  bb  |
|  bb  bb  bb  bb  bb  bb  |
|  bb  bb          bb  bb  |
|  bb  bb          bb  bb  |
|          bb  bb          |
|          bb  bb          |
|bb  bbbb          bbbb  bb|
|ss  bbbb          bbbb  ss|
|          bb  bb          |
|          bbbbbb          |
|  bb  bb  bbbbbb  bb  bb  |
|  bb  bb  bb  bb  bb  bb  |
|  bb  bb  bb  bb  bb  bb  |
|  bb  bb  bb  bb  bb  bb  |
|  bb  bb          bb  bb  |
|  bb  bb          bb  bb  |
|  bb  bb   bbbb   bb  bb  |
|           beeb           |
|           beeb           |
----------------------------